==========
=######===
=#    #===
=# CC ###=
=### E  #=
===#  X #=
===#  X##=
===#####==
==========
==========