==========
=#####====
## E ####=
#  #  X ##
# #      #
# CC #X  #
##    ####
=##   #=== 
==#####===
==========